74 -1 -1 84 -1 -1 -1 -1
74 -1 -1 -1 -1 -1 -1 -1
71 -1 -1 88 -1 -1 -1 -1
92 -1 -1 90 -1 -1 -1 -1
74 73 82 84 87 -1 -1 -1
95 -1 -1 97 -1 -1 -1 -1
71 -1 -1 96 -1 -1 -1 -1
71 -1 -1 88 -1 -1 -1 -1
