71 -1 89 -1 94 -1 98 -1
94 72 75 80 90 -1 -1 -1
81 74 -1 -1 92 -1 99 -1
82 -1 -1 -1 -1 -1 -1 -1
86 85 89 91 90 95 97 -1
71 -1 75 -1 90 -1 -1 -1
71 -1 75 -1 90 -1 -1 -1
71 -1 84 -1 -1 -1 -1 -1
