3 36 6 11 44 25 61 26
1 2 8 35 15 41 43 29
0 6 5 11 19 21 22 26
4 8 6 11 24 21 41 29
7 13 5 22 14 25 35 29
2 20 5 32 37 44 59 30
2 4 20 11 49 21 53 30
1 9 6 24 31 21 76 30
