62 28 64 34 46 88 57 68
45 36 50 40 46 60 65 87
27 28 32 34 56 51 57 68
47 36 63 76 62 83 66 77
55 38 66 43 62 69 65 70
77 45 79 64 67 86 66 70
87 38 93 40 56 96 66 68
78 61 -1 40 67 -1 82 97
