5 14 6 19 9 22 27 42
1 2 6 8 9 17 28 38
1 5 30 12 11 31 36 59
1 29 6 35 19 21 44 61
2 15 6 22 11 18 39 41
3 7 14 10 9 16 17 21
3 45 30 64 19 54 71 82
5 11 8 18 9 16 62 73
