95 94 -1 -1 -1 -1 -1 -1
93 94 -1 -1 -1 -1 -1 -1
95 -1 -1 -1 -1 -1 -1 -1
95 94 -1 -1 -1 -1 -1 -1
-1 -1 -1 -1 -1 -1 -1 -1
92 94 95 -1 -1 -1 -1 -1
99 97 -1 -1 -1 -1 -1 -1
92 97 -1 -1 -1 -1 -1 -1
