43 46 72 90 53 -1 51 59
28 56 71 76 49 87 51 59
32 47 68 74 85 -1 63 58
28 33 83 -1 52 -1 51 58
32 33 42 43 45 47 63 59
28 33 -1 -1 46 -1 57 59
37 47 93 99 -1 -1 52 58
45 54 40 56 48 -1 63 59
