0 1 2 3 8 14 42 61
9 31 11 57 63 12 22 65
10 18 11 22 25 12 16 66
19 29 27 54 75 14 18 80
4 13 7 20 37 12 29 38
3 7 2 19 88 40 16 -1
9 26 7 27 34 14 18 86
1 9 2 14 21 12 16 24
