26 29 78 -1 44 -1 50 -1
23 29 40 63 76 56 49 52
27 29 66 76 41 46 49 82
23 24 68 74 33 55 51 53
27 29 51 -1 33 47 50 55
40 24 30 31 33 53 49 52
23 24 -1 -1 33 60 50 61
26 46 93 -1 44 -1 50 52
