66 71 80 88 -1 94 96 98
64 67 73 90 95 91 96 -1
64 72 80 95 -1 94 -1 -1
86 67 73 78 -1 -1 96 -1
65 89 73 90 79 91 94 98
65 67 73 78 -1 99 96 98
68 89 73 78 -1 94 96 -1
66 -1 92 -1 -1 -1 96 -1
