95 54 -1 40 -1 49 -1 90
-1 34 -1 58 -1 49 -1 -1
30 37 36 55 41 93 44 45
71 31 81 40 92 42 99 90
-1 32 -1 43 -1 49 -1 97
37 31 79 40 -1 42 -1 97
70 37 74 43 87 48 88 90
75 32 80 43 89 48 96 93
