-1 70 -1 -1 95 -1 -1 93
-1 70 81 -1 -1 -1 -1 -1
75 64 77 92 -1 83 -1 96
63 87 84 -1 95 -1 -1 -1
71 80 86 78 79 83 88 97
93 65 77 94 95 86 -1 90
-1 65 77 -1 95 86 -1 93
87 65 81 -1 -1 83 -1 90
