58 59 71 -1 -1 78 -1 86
-1 79 80 -1 -1 -1 -1 84
63 59 96 69 72 77 78 84
51 60 62 -1 -1 77 -1 84
54 60 71 -1 -1 88 -1 86
-1 70 80 -1 -1 89 -1 86
52 60 62 98 -1 78 -1 95
55 59 71 -1 -1 77 -1 86
