37 54 31 -1 51 66 -1 74
34 28 60 -1 51 66 -1 74
24 27 31 60 45 47 72 67
24 27 31 48 45 47 51 61
44 48 42 36 72 66 56 76
37 27 42 50 88 47 81 74
30 28 42 -1 45 57 -1 67
24 28 63 55 64 47 80 67
