0 2 5 6 17 42 23 53
4 16 39 52 17 54 22 68
3 6 10 15 14 18 19 20
0 13 4 28 14 34 21 43
0 2 11 22 17 23 19 33
5 20 8 25 17 46 33 49
9 13 69 73 25 -1 19 -1
8 13 12 16 17 21 19 44
