94 -1 -1 -1 -1 -1 -1 -1
99 -1 -1 -1 -1 -1 -1 -1
94 -1 -1 -1 -1 -1 -1 -1
94 -1 -1 -1 -1 -1 -1 -1
96 -1 -1 -1 -1 -1 -1 -1
94 -1 -1 -1 -1 -1 -1 -1
94 -1 -1 -1 -1 -1 -1 -1
-1 -1 -1 -1 -1 -1 -1 -1
