20 74 76 52 -1 -1 -1 70
85 27 -1 52 -1 -1 -1 49
35 27 40 43 80 88 90 53
45 27 73 30 -1 -1 -1 50
71 27 84 43 -1 -1 -1 69
91 78 95 52 -1 -1 -1 54
79 71 99 30 -1 -1 -1 48
22 27 28 30 36 38 42 52
