1 8 6 11 16 50 22 28
0 3 6 9 24 29 28 27
0 13 8 18 15 51 31 29
7 16 11 36 15 45 21 25
2 5 9 17 21 20 30 27
1 2 26 78 42 84 89 51
17 26 11 52 15 71 24 25
0 12 18 49 24 60 65 30
