80 91 61 82 -1 -1 -1 -1
55 56 61 63 70 78 76 83
-1 98 74 -1 -1 89 -1 -1
-1 77 71 63 -1 73 -1 -1
64 91 71 63 85 89 87 92
-1 77 61 63 -1 73 -1 -1
-1 93 61 -1 -1 96 -1 -1
90 98 74 76 -1 96 -1 -1
