33 62 45 46 68 70 74 54
32 33 36 35 37 41 42 54
75 66 34 82 95 87 -1 58
32 46 34 35 91 41 -1 53
32 48 34 35 54 41 58 53
32 98 34 46 -1 56 -1 58
37 72 80 35 97 95 -1 53
55 69 45 46 75 70 81 58
