3 10 6 7 21 19 22 20
3 11 6 7 14 28 23 42
3 25 10 11 39 13 50 20
5 9 10 26 12 13 27 32
0 35 15 14 37 36 44 22
9 15 10 7 -1 13 -1 22
0 4 12 14 19 13 24 49
1 8 25 26 16 27 18 42
