46 60 57 69 71 97 83 87
69 53 90 -1 71 85 -1 -1
46 53 75 76 70 79 85 81
69 60 72 78 75 79 89 81
50 -1 -1 -1 88 85 -1 -1
76 53 -1 -1 88 89 -1 -1
50 53 66 77 70 79 80 92
50 60 -1 -1 70 -1 -1 -1
