-1 30 -1 -1 60 -1 -1 -1
26 28 40 49 42 48 50 57
33 29 45 40 60 48 64 65
82 40 -1 47 44 64 -1 -1
46 33 53 34 63 58 71 79
-1 33 -1 -1 67 48 -1 -1
58 29 69 35 42 48 74 80
-1 29 -1 39 55 58 -1 -1
