0 1 2 3 6 7 23 37
5 47 67 92 38 26 23 41
3 26 29 33 9 12 15 16
3 9 18 43 6 10 23 24
3 31 37 41 6 7 22 24
13 23 64 77 9 26 22 36
1 8 21 66 4 26 33 49
2 10 12 19 4 7 15 16
