65 -1 -1 -1 84 87 -1 -1
57 90 -1 -1 81 93 -1 -1
65 72 94 96 82 93 98 -1
65 -1 -1 -1 -1 96 -1 -1
57 58 -1 -1 82 83 -1 -1
57 58 94 -1 82 83 -1 -1
-1 72 94 -1 84 92 -1 -1
69 58 72 78 92 96 86 -1
