80 83 -1 99 -1 -1 -1 -1
80 82 84 88 -1 -1 -1 -1
-1 -1 95 99 -1 -1 -1 -1
68 77 84 99 -1 -1 -1 -1
68 77 84 88 -1 -1 -1 -1
-1 77 -1 88 -1 -1 -1 -1
68 83 98 99 -1 -1 -1 -1
80 89 94 97 -1 -1 -1 -1
