4 6 15 33 43 45 60 82
3 6 23 17 38 29 86 -1
10 15 12 23 26 24 28 29
3 8 16 17 18 19 24 47
5 7 56 21 61 24 -1 -1
13 15 20 18 21 19 25 34
13 41 39 17 49 24 50 65
4 7 8 17 33 28 46 73
