61 81 -1 -1 -1 -1 83 87
61 81 -1 -1 -1 -1 78 89
69 -1 -1 -1 -1 -1 78 -1
60 62 75 82 83 -1 78 90
69 62 -1 -1 -1 -1 -1 84
60 62 67 73 74 77 88 87
79 81 -1 -1 -1 -1 78 87
69 62 -1 -1 -1 -1 78 93
