-1 96 -1 -1 -1 -1 -1 -1
-1 94 -1 -1 -1 -1 -1 -1
-1 -1 -1 -1 -1 -1 -1 -1
-1 95 -1 -1 -1 -1 -1 -1
-1 -1 -1 -1 -1 -1 -1 -1
93 95 96 97 99 -1 -1 -1
-1 94 -1 -1 -1 -1 -1 -1
-1 94 -1 -1 -1 -1 -1 -1
