36 59 68 45 71 73 90 55
31 44 -1 71 -1 57 -1 98
28 -1 -1 -1 -1 56 -1 -1
28 39 63 48 69 52 72 55
31 39 59 53 87 57 -1 65
28 44 41 48 50 52 53 55
49 68 40 70 95 75 98 77
49 44 79 48 80 51 88 65
