26 78 57 -1 63 -1 -1 79
26 29 35 47 62 54 57 71
31 -1 91 39 97 -1 -1 66
70 69 34 44 90 80 -1 64
31 73 60 91 62 92 98 64
26 -1 41 48 49 -1 -1 61
29 33 60 56 61 79 90 71
26 41 35 40 49 59 96 63
