43 38 44 45 59 47 50 60
29 37 48 45 46 57 58 95
59 70 54 45 46 72 73 74
29 56 49 61 46 84 87 88
29 -1 43 88 60 -1 -1 -1
29 34 41 61 59 66 69 81
90 97 98 50 71 -1 -1 -1
43 90 92 50 60 -1 -1 -1
