17 22 3 36 44 54 70 75
2 16 4 20 14 18 21 24
0 2 6 53 11 15 -1 -1
1 8 4 9 14 20 41 46
1 13 8 37 11 24 38 58
1 5 10 62 11 39 64 81
2 6 3 10 11 15 25 27
0 12 3 19 11 18 28 31
