81 63 65 -1 -1 -1 -1 -1
86 -1 74 80 -1 -1 -1 91
62 63 65 97 -1 85 -1 99
62 63 65 -1 -1 85 -1 91
69 63 -1 97 -1 -1 -1 99
62 72 82 80 83 85 86 91
69 -1 74 80 -1 -1 -1 91
-1 72 74 80 -1 85 -1 99
