1 10 3 19 15 26 18 25
1 13 3 15 8 22 16 26
0 9 11 27 14 32 19 41
5 23 3 30 14 35 16 25
4 28 37 77 66 -1 16 25
0 1 3 14 8 18 16 35
5 21 11 36 58 75 77 41
5 6 3 7 15 11 38 70
