11 1 3 14 23 24 19 28
21 1 3 35 7 -1 37 -1
2 1 15 8 5 9 19 12
0 1 3 4 5 15 10 29
6 4 3 18 7 25 10 41
0 1 31 11 54 32 44 38
2 4 32 74 40 86 44 91
0 14 3 7 5 23 19 37
