45 -1 -1 -1 -1 76 -1 84
99 49 57 80 81 73 -1 -1
61 89 92 94 98 70 99 83
-1 -1 -1 94 -1 -1 -1 85
83 56 60 94 97 -1 -1 85
45 -1 -1 -1 -1 74 -1 85
87 -1 -1 -1 -1 -1 -1 -1
45 53 55 66 67 69 79 85
