13 30 49 50 58 66 48 -1
43 30 53 -1 -1 -1 73 -1
28 16 26 31 33 34 36 43
13 16 26 44 52 53 48 54
13 16 51 57 81 82 36 84
43 61 26 48 90 92 36 96
43 50 64 -1 -1 -1 48 -1
25 30 26 40 64 85 79 -1
