14 61 63 27 52 85 56 87
2 7 8 4 13 12 18 19
3 6 14 32 41 31 21 34
6 48 62 4 5 -1 21 -1
0 1 3 7 13 24 37 39
1 35 38 4 5 52 18 58
2 9 11 39 41 15 44 -1
1 10 17 8 5 30 18 37
