88 -1 -1 -1 -1 -1 -1 -1
93 -1 -1 -1 -1 -1 -1 -1
86 -1 -1 -1 -1 -1 -1 -1
-1 -1 -1 -1 -1 -1 -1 -1
88 -1 -1 -1 -1 -1 -1 -1
86 -1 -1 -1 -1 -1 -1 -1
96 -1 -1 -1 -1 -1 -1 -1
86 91 -1 -1 -1 -1 -1 -1
