-1 57 46 28 38 47 -1 40
21 23 27 28 29 32 36 66
68 58 63 28 29 91 82 40
-1 26 89 55 49 -1 -1 74
43 26 46 50 38 84 51 69
-1 26 46 28 29 47 -1 40
-1 26 59 70 29 -1 -1 73
44 23 89 36 49 47 50 40
