-1 -1 57 -1 -1 77 94 -1
-1 -1 83 -1 -1 76 -1 -1
49 51 77 65 69 73 85 97
59 61 55 79 83 75 87 95
88 89 55 99 -1 80 78 94
88 -1 77 -1 -1 -1 -1 95
88 -1 57 -1 -1 71 78 95
87 -1 57 -1 -1 72 81 93
