67 75 51 52 77 39 79 86
25 35 30 36 37 48 44 47
85 -1 70 98 -1 -1 -1 -1
43 45 35 36 84 39 99 -1
87 91 35 52 -1 60 -1 -1
42 74 37 36 78 39 80 89
26 27 71 52 49 60 82 95
38 40 30 36 70 48 92 96
