-1 -1 -1 -1 -1 -1 -1 -1
93 94 -1 -1 -1 -1 -1 -1
-1 -1 -1 -1 -1 -1 -1 -1
88 -1 -1 -1 -1 -1 -1 -1
98 -1 -1 -1 -1 -1 -1 -1
88 -1 -1 -1 -1 -1 -1 -1
93 -1 -1 -1 -1 -1 -1 -1
93 -1 -1 -1 -1 -1 -1 -1
