66 69 82 77 85 97 -1 -1
-1 -1 78 93 85 -1 -1 -1
-1 -1 72 94 93 99 -1 -1
-1 68 72 -1 85 -1 -1 -1
-1 -1 90 -1 96 -1 -1 -1
-1 73 82 96 94 97 -1 -1
84 70 82 91 93 97 -1 -1
-1 -1 82 99 93 97 -1 -1
