15 23 60 7 27 62 31 40
0 5 8 9 16 15 22 29
11 22 32 9 16 76 20 42
0 1 4 7 13 19 22 24
3 46 71 26 27 73 22 28
19 28 29 26 16 31 20 24
4 11 14 7 13 21 43 24
8 9 17 7 25 34 20 28
