58 55 -1 57 66 -1 91 -1
51 54 55 56 89 68 91 84
-1 55 -1 58 74 -1 91 90
57 54 -1 56 67 -1 69 81
53 65 -1 56 77 -1 80 84
-1 65 97 58 66 -1 69 81
50 73 97 92 77 -1 80 84
-1 54 -1 62 74 -1 80 94
