24 30 54 34 38 53 57 64
74 45 54 79 88 75 63 89
24 71 33 81 83 56 57 95
19 30 33 87 -1 56 63 -1
19 45 73 -1 -1 75 76 -1
19 27 68 -1 -1 78 88 -1
24 30 33 49 56 54 57 63
24 27 66 45 61 84 91 -1
