0 3 6 13 10 12 15 16
4 14 10 9 22 59 67 40
11 28 47 9 32 48 65 16
1 13 6 9 43 71 76 39
0 11 6 25 23 26 29 16
4 47 12 14 74 90 -1 18
0 1 22 25 35 44 46 29
3 18 6 9 39 40 42 16
