24 84 67 73 88 98 46 -1
24 31 46 49 37 41 42 53
24 38 45 47 40 41 42 81
24 30 40 70 37 41 46 82
26 30 -1 -1 47 41 49 -1
26 53 65 91 35 54 60 92
82 30 31 34 35 92 46 43
26 31 48 75 35 58 42 76
