-1 -1 -1 -1 -1 -1 -1 -1
-1 -1 -1 -1 -1 -1 -1 -1
92 94 96 97 99 -1 -1 -1
91 -1 96 -1 -1 -1 -1 -1
-1 -1 96 -1 -1 -1 -1 -1
-1 -1 99 -1 -1 -1 -1 -1
93 98 99 -1 -1 -1 -1 -1
-1 -1 95 -1 -1 -1 -1 -1
