8 23 31 38 42 52 53 99
1 21 28 49 69 79 86 92
3 30 36 54 60 11 61 68
0 3 5 6 7 8 9 10
8 22 55 66 87 -1 -1 -1
6 13 29 34 43 12 57 71
6 46 -1 -1 -1 16 -1 -1
6 39 51 67 90 -1 -1 -1
