26 29 36 38 40 41 43 45
54 63 84 38 40 61 88 72
58 61 32 38 40 41 71 45
28 48 55 44 40 57 67 58
49 -1 33 38 43 80 -1 94
-1 -1 -1 55 62 41 -1 67
47 52 30 38 62 61 65 45
59 68 31 38 66 41 -1 98
