14 20 -1 43 71 54 47 77
14 29 -1 30 57 73 68 76
22 18 72 26 40 41 47 78
17 18 19 30 40 55 60 56
14 20 -1 30 35 41 47 -1
17 18 81 26 56 77 79 75
39 69 -1 43 81 41 79 80
14 29 -1 34 35 54 68 -1
