86 72 -1 -1 88 92 -1 -1
59 87 -1 -1 84 91 -1 -1
59 62 85 88 84 92 94 98
76 72 73 74 94 93 -1 -1
59 62 -1 -1 94 -1 -1 -1
64 62 97 -1 -1 95 -1 -1
59 72 -1 -1 89 -1 -1 -1
85 72 -1 -1 84 91 -1 98
