63 69 81 74 76 -1 83 -1
82 -1 -1 90 -1 -1 83 -1
-1 -1 81 -1 -1 -1 83 -1
63 69 92 74 76 97 98 -1
82 97 -1 -1 -1 -1 -1 -1
70 85 80 -1 76 -1 -1 -1
63 69 72 75 76 79 83 96
70 72 81 75 79 -1 83 -1
