7 36 47 4 13 15 50 65
3 5 8 4 13 17 16 23
0 1 3 4 23 62 18 31
3 12 38 5 23 42 61 62
3 6 14 18 13 21 28 53
2 9 21 12 13 15 34 39
1 11 26 12 16 17 30 33
7 58 68 28 39 15 82 84
