30 34 78 93 42 44 56 59
24 36 94 -1 52 60 -1 59
27 48 32 35 43 47 68 71
45 36 70 85 95 50 56 59
27 48 54 77 45 60 73 96
24 29 55 64 73 44 68 84
27 29 49 57 41 47 61 59
24 48 86 92 98 47 61 65
