3 16 9 39 33 51 61 25
7 12 9 17 15 36 33 23
0 1 6 18 13 20 21 23
16 26 34 32 15 21 38 25
1 8 12 27 15 20 97 25
11 44 6 51 15 27 58 25
1 11 6 28 48 20 29 81
1 3 9 10 13 21 36 23
