-1 -1 -1 86 66 -1 -1 -1
54 63 60 65 66 74 85 87
84 55 88 64 66 83 98 -1
93 55 -1 71 66 87 91 -1
-1 68 -1 77 66 93 85 -1
-1 63 -1 64 89 83 85 -1
-1 55 -1 96 66 83 -1 -1
77 68 89 71 66 74 96 -1
