5 9 21 8 18 80 -1 -1
9 15 18 8 16 12 22 24
7 13 16 10 11 12 17 23
0 56 66 22 28 12 70 72
2 25 27 10 11 12 31 32
2 3 6 26 31 65 51 -1
4 20 44 8 23 39 54 55
14 52 75 22 35 12 84 85
