19 25 5 30 16 37 53 20
1 4 3 58 22 62 71 25
2 31 55 66 16 68 -1 45
0 1 3 12 15 16 18 45
4 13 5 14 15 28 52 21
0 6 5 21 16 27 60 20
8 9 40 11 53 29 32 21
12 22 18 26 16 50 54 20
