28 33 38 46 47 56 65 59
54 45 38 41 63 92 -1 64
27 -1 38 74 77 -1 -1 92
27 36 65 74 48 49 51 64
24 44 50 41 56 64 72 61
24 61 38 41 47 63 70 59
27 35 71 41 56 55 57 72
44 42 38 46 47 73 86 72
