80 77 79 -1 -1 99 -1 -1
67 75 84 -1 -1 -1 -1 -1
93 78 -1 -1 -1 -1 -1 -1
80 -1 -1 -1 -1 96 -1 -1
67 82 79 84 87 90 -1 -1
75 81 79 83 89 90 93 99
80 76 88 91 -1 90 -1 -1
88 74 89 94 -1 90 -1 -1
