-1 -1 62 73 78 -1 -1 -1
67 85 72 76 91 87 89 90
63 85 76 73 -1 -1 -1 -1
60 61 68 76 91 -1 -1 -1
59 74 90 83 78 81 97 -1
-1 70 72 73 -1 -1 -1 -1
68 61 62 73 78 96 -1 -1
-1 61 62 76 91 -1 -1 -1
