1 3 7 26 32 31 41 50
11 14 5 10 12 20 24 40
30 86 31 10 49 95 -1 21
4 8 17 14 25 13 16 19
0 18 5 10 12 28 34 19
4 15 7 10 12 17 32 21
1 6 5 14 24 22 36 50
2 9 5 42 12 21 23 19
