67 46 -1 81 -1 -1 98 -1
45 56 76 61 80 -1 -1 -1
67 70 -1 82 -1 -1 98 -1
45 46 -1 61 -1 -1 99 -1
45 46 56 61 62 64 66 69
86 56 -1 90 -1 -1 -1 -1
62 70 -1 69 -1 -1 97 -1
62 46 77 69 78 81 96 98
