65 -1 27 -1 35 -1 49 77
25 26 59 29 39 38 55 44
-1 -1 34 -1 39 -1 50 54
40 67 37 -1 58 -1 -1 44
37 39 27 51 35 53 48 54
75 83 27 -1 35 -1 -1 77
54 89 78 92 87 -1 42 44
57 58 34 59 39 70 43 44
