29 32 60 -1 -1 98 -1 -1
-1 45 53 -1 69 49 -1 -1
28 58 69 42 74 98 80 -1
36 32 67 73 72 98 85 -1
30 58 41 96 79 49 -1 -1
27 45 41 68 70 59 84 91
37 32 41 -1 -1 55 -1 -1
31 32 41 44 46 49 50 52
