1 5 8 11 12 38 24 58
1 13 10 11 15 24 23 77
3 6 10 22 14 18 23 25
1 19 8 22 50 26 21 45
5 16 25 62 51 82 24 89
7 9 10 11 53 63 28 65
1 -1 14 22 -1 -1 38 -1
1 3 10 11 17 33 23 34
