-1 -1 -1 75 -1 -1 97 -1
-1 -1 -1 63 -1 79 76 -1
-1 -1 -1 -1 -1 90 -1 -1
-1 -1 -1 68 -1 71 76 81
-1 -1 -1 68 -1 71 85 91
92 -1 -1 62 -1 71 76 81
-1 -1 -1 75 -1 93 98 -1
55 56 59 75 67 93 85 81
