3 25 19 47 5 48 54 34
7 11 24 26 25 -1 -1 54
7 10 18 31 26 -1 -1 20
14 29 15 36 12 49 61 35
0 23 22 35 12 42 43 16
2 7 12 32 8 34 37 20
0 1 2 3 5 6 9 34
0 20 13 38 8 57 70 16
