22 24 26 30 33 39 40 57
34 71 31 87 -1 43 -1 60
34 -1 26 -1 -1 53 -1 60
64 37 31 42 52 93 58 61
22 76 31 85 89 46 -1 50
34 88 31 93 -1 53 -1 57
22 46 26 51 55 39 57 50
29 47 26 48 -1 43 -1 61
