-1 64 67 -1 -1 74 -1 -1
60 69 66 71 73 86 79 80
-1 67 66 -1 -1 94 -1 -1
-1 63 69 -1 -1 86 -1 -1
-1 68 67 -1 -1 74 -1 -1
-1 65 66 -1 -1 94 -1 -1
-1 62 69 -1 -1 85 -1 -1
-1 61 66 -1 -1 85 -1 -1
