3 2 7 9 36 18 14 21
6 2 8 17 16 18 67 21
3 30 13 35 17 25 74 21
1 30 5 6 10 11 36 47
1 9 41 49 17 11 65 21
0 2 15 25 10 18 86 74
1 2 4 20 10 11 29 24
6 9 28 31 16 25 38 24
