-1 -1 88 92 -1 -1 -1 -1
81 87 88 90 94 95 -1 -1
-1 -1 -1 -1 -1 -1 -1 -1
-1 -1 -1 92 -1 -1 -1 -1
-1 89 -1 -1 -1 -1 -1 -1
-1 87 -1 92 -1 -1 -1 -1
-1 87 88 90 -1 -1 -1 -1
-1 89 -1 92 -1 -1 -1 -1
