23 21 -1 54 -1 50 -1 65
14 21 31 34 42 48 50 56
39 83 37 38 50 46 77 -1
23 27 -1 34 -1 76 -1 51
31 33 57 38 72 48 75 51
14 21 28 42 39 48 54 51
31 63 -1 38 -1 64 -1 75
77 27 70 93 83 47 91 -1
