53 56 64 71 72 76 86 98
-1 -1 62 66 -1 75 88 95
-1 -1 -1 63 -1 76 89 99
92 -1 -1 95 -1 75 83 -1
-1 -1 61 66 -1 75 86 94
-1 -1 -1 63 -1 75 83 99
70 73 60 63 80 78 91 -1
-1 -1 -1 67 -1 87 83 97
