19 35 76 4 5 85 7 97
3 9 10 4 6 26 7 27
0 2 3 4 5 6 7 12
12 24 33 4 15 38 28 44
3 13 19 16 5 22 7 56
0 15 16 4 5 17 9 23
13 25 89 49 61 92 7 93
36 40 45 16 15 49 7 52
