98 -1 -1 77 -1 -1 83 -1
67 58 70 91 -1 -1 -1 -1
98 70 -1 -1 -1 -1 85 -1
97 81 -1 90 -1 -1 96 -1
-1 70 -1 77 -1 -1 90 -1
54 71 69 77 80 81 84 88
-1 58 -1 84 -1 -1 91 -1
98 58 -1 77 -1 -1 86 -1
