97 86 85 -1 -1 -1 90 -1
67 71 80 82 83 89 94 99
67 78 79 98 -1 -1 96 -1
89 -1 87 -1 -1 -1 97 -1
67 69 74 76 92 93 91 -1
