2 11 36 60 22 53 23 26
0 1 4 8 15 24 62 78
1 6 19 15 10 16 43 44
12 19 4 15 25 30 23 26
1 27 4 8 29 37 23 26
