61 83 34 35 -1 -1 68 -1
28 33 97 66 36 42 98 49
40 60 34 35 68 70 45 79
31 38 34 35 46 47 45 56
43 44 56 66 57 63 68 85
