0 2 8 29 35 16 23 36
3 18 29 12 14 32 23 25
3 4 5 17 28 34 40 36
3 20 31 17 14 35 23 25
8 19 27 12 14 28 40 46
