-1 73 -1 -1 65 -1 77 -1
50 70 69 92 65 -1 77 -1
97 51 98 -1 65 -1 77 -1
58 51 62 64 65 66 86 78
91 70 -1 -1 -1 -1 73 -1
