26 37 40 52 53 57 58 60
53 37 55 61 48 57 58 63
45 37 47 93 87 56 70 72
36 61 43 46 82 85 86 75
39 47 42 51 48 60 58 64
