-1 94 -1 -1 -1 -1 -1 -1
-1 87 -1 -1 -1 -1 -1 -1
-1 86 -1 -1 -1 -1 -1 -1
81 89 -1 -1 -1 -1 -1 -1
-1 84 -1 -1 -1 -1 -1 -1
